accomplish a task	hoàn thành bài kiểm tra
adapt to change	thích nghi để thay đổi
approach	tiếp cận	
bold and direct	đậm và trực tiếp
concerned about	liên quan về
further developed	tiếp tục phát triển
focused on the task	trung tâm vào công việc
characterize	tính cách
constantly look for change	liên tục tìm kiếm sự thay đổi
develop flexibility phát triển linh hoạt
distract from	phân tâm
dominate	thống nhất
feel uneasy	cảm thấy không dễ dàng
illustrate	minh họa
influence	ảnh hưởng
intend to be rude	có ý định thô lỗ
invest a lot of emotion and energy	đầu tư rất nhiều cảm xúc và năng lượng
love to be involved in/engaged in many things at once	thích tham gia
love to engage in a spirited discussion	thích tham gia vào một cuộc thi thảo luận 
miss the details	nhớ chi tiết
overwhelm/to be overwhelmed by the news	choáng ngợp bởi thông tin
resolve conflict	xử lý xung đột
thrive on	phát triển mạnh lên
welcome challenges	chào đón thách thức.
appropriate information	thông tin thích hợp
change threatens the status quo	thay đổi đe dọa hiện trạng
comfortable with conflict	thích hợp với đe dọa
conflict-handling	giải quyết xung đột
considerate = caring = kind	thận trọng
Description	sự miêu tả
exciting adventure	cuộc phiêu lưu thú vị
expressive = spirited	biểu cảm
interpersonal relationship	mối quan hệ giữa các cá nhân
intimidating = scary	đáng sợ
no longer	không còn nữa
preserving	bảo quản 
self-assessment	tự đánh giá bản thân
soft-hearted	trái tim mềm yếu
temperament	tính khí
the context of the task 
contest	cuộc thi
the proper order of things	thứ tự thích hợp của sự vật
the risk of damaging relationships	thủ thuật giao tiếp
value	giá trị
very rate	rất hiếm khi
whatever is required to get the job done	bất cứ điều gì cần cho công việc


